{
    "tileType" : "Grass_Grid_"
    "tileNames" : [
                   "Floor",
                   "Exit"
                   ],
    "width" : 15,
    "height" : 15,
    
    "tileWidth" : 128,
    "tileHeight" : 128,
    
    "playerSpawnX" : 24,
    "playerSpawnY" : 0,
    
    "layers" : [
                {
                "name" : "Background",
                "tiles" : [
                           [1, 1, 1, 1, 2, 1, 1, 1, 2, 1, 1, 1, 1, 1, 1],
                           [1, 1, 2, 1, 2, 1, 2, 1, 2, 1, 2, 1, 1, 1, 1],
                           [1, 1, 2, 1, 2, 1, 2, 1, 2, 1, 2, 2, 2, 2, 2],
                           [1, 1, 2, 1, 2, 1, 2, 1, 2, 1, 1, 1, 1, 1, 2],
                           [1, 1, 2, 1, 2, 1, 2, 2, 2, 2, 2, 2, 2, 1, 2],
                           [2, 2, 2, 1, 2, 1, 1, 1, 1, 1, 1, 1, 1, 1, 1],
                           [1, 1, 2, 1, 2, 1, 2, 2, 2, 2, 2, 2, 2, 2, 2],
                           [1, 1, 2, 1, 2, 1, 2, 1, 1, 1, 1, 1, 1, 1, 1],
                           [1, 1, 2, 1, 2, 1, 2, 2, 2, 2, 2, 2, 2, 2, 2],
                           [1, 1, 2, 1, 2, 1, 1, 1, 1, 2, 1, 1, 1, 1, 1],
                           [1, 1, 2, 1, 2, 2, 2, 2, 1, 2, 1, 2, 2, 2, 2],
                           [1, 1, 2, 1, 1, 1, 1, 1, 1, 1, 1, 2, 1, 1, 1],
                           [1, 1, 1, 1, 1, 1, 1, 1, 1, 1, 1, 1, 1, 2, 2],
                           [1, 1, 1, 1, 1, 1, 1, 1, 1, 1, 1, 1, 1, 1, 1],
                           [1, 1, 1, 1, 2, 2, 2, 1, 1, 1, 1, 1, 2, 2, 2]
                           ]
                }
                ]
    
}
